111111111
100000C01
1P000E1O1
111111111